11111111111111111111
1100MN0000C0000000M1
11N010M011110C011111
11111110111110111111
1P0000000C0M000000E1
11111111111111111111